11111111111111111111111
10001000101010101000001
10111011101010101010111
10000010001000101010101
11101010111110101011101
10101010000000000000001
10101110111011101111101
10001000001000101000001
10101111101111111111101
10101000000000100010001
10101110111011101111111
10101000001010000010001
11101011111111101111101
10001000100010000000001
11101010101111111011111
10100010100010001000001
10101110111010101010101
10101010100010100010101
10101010111011101110101
10100010101000000010101
10101110101111101111101
10000010000000000010001
11111111111111111111111