1111111111111111111111111111111111111111111
1000001000000000100000000010000010001000001
1011111110111111111111111011101110111110111
1000001000001000000000100010001000100000001
1111101010101110111011101011101110101011101
1000001010100010001000101000001000101010001
1011101010111011111010101011101010111111101
1000100010100000001010001010000010000000001
1111101110101111111011111111111111111110111
1000000010101010100010000000101000000000001
1010111111101010101110111011101110101011101
1010101010000010100000101010100010101010001
1111101011111010101110101110101111111110111
1000100000000000000010001010100010000000001
1011111110111011111011111010101011111011101
1000100000001010001000100000101010100010001
1110111010111110111111101111111010111011111
1000100010100010001000000000100000001010001
1011101111101010111010111110111110111010111
1010000000101010000010000010100000000000001
1010111110101010101110111111111111101010101
1000001010101010100010100000100010101010101
1010111011101010111011101111111010101011111
1010001000001000100010100000101010101000101
1110111010111111111110111110101010101111101
1000001010000010100000001000100000100010001
1011101110101110111011101011101110111010101
1000101000101000101000101000001000000000101
1011111010111010101110111011111110101111101
1000100010100010100000001000100010101000001
1110111011111010101010111111101111101110111
1010001000000010001010001000001010101000001
1011111011101111101011101111101010101111111
1000001010100010001000101000100010000000101
1111101010101110101011101110111011101110101
1000001010000010101000100010101010000010101
1110111110111111111111101110101011111011101
1000000000001010000000001000001010100000001
1111111110111011111110101011101010101011101
1010001000101010001010101010001010001010001
1011101110101011101011101011101010101110111
1000000000000010000000000010000000101000001
1111111111111111111111111111111111111111111