11111111111
10101010001
10101010111
10001010001
11101010101
10000000101
11111011101
10000010001
11101111101
10001000001
11111111111