111111111111111
100000100000001
101110101010101
100010101010101
101110101111111
101000100000101
111110111011101
100010000010101
101111101110101
100010000010001
101111111010111
101000000000101
101011101110101
100000100010001
111111111111111