111111111111111111111111111111111
100000100000101000000000000000101
111110101110101110111011111110101
100000000010100010100000000010001
111110111011101010111111101110111
101010100000001010001000000010101
101011111110111111101110111011101
100000001000001000101010001000001
101111111110111010111011101110101
100000000010000010001000000010101
101010111010101110111011101011111
101010001010101000001000101010101
101111111011101110101010111010101
100010001000000010101010100010101
101011101010111111111010111110101
101000101010000010101010000010001
101110101110101110101111101111101
101000000010101000000010100010001
101111101111111011111010101111101
100000100010101000101000000000001
111011101110101111101110111011111
100010100000001000100000100000001
111110101111111110101111111010111
100010001010001010000000001010001
101110111010111011111011101011101
101000000000000010000010101000101
101110101111111011101110101010111
100000100010001000100010101010001
111110111111101010111010101111101
100000000010001010000010001000001
101111111011101011101010101010111
100000100000100000101010101010001
111111111111111111111111111111111