111111111111111111111
100000100000100010001
111110101111101010111
100000000010001010001
111110111010111110111
100000101000000000001
111010101010111011101
101010001010100010001
101111101110111011111
100000101000001010001
101110101111101111101
101010001000101000001
101011101010111011101
100010001010001010001
101110111011111011111
101000000000100000001
101011111010111010111
101010000010000010001
101111101111101110101
100010000000101000101
111111111111111111111