11111111111111111
10101000001000001
10101010101111101
10000010101010001
11111110111010101
10001010001010101
10111010111011101
10001000000000001
10111110111110101
10000000001000101
11111110111110111
10000000100010001
10111111101010111
10100000001010101
10101111101110101
10101000000000001
11111111111111111