1111111111111111111
1010000010100000001
1010111110111011101
1000000000100000101
1011101110101110101
1010000010101000101
1110111110101111111
1010000010000010101
1011111011101010101
1000000010001010001
1011101011101010111
1010001000101000001
1111111011111111101
1000000000101000001
1011111111101111101
1010000000100000001
1110111010111011111
1000001010000000001
1111111111111111111