1111111111111
1000000000101
1011111111101
1010001000101
1010111011101
1000000000001
1011111011111
1010000010101
1011111010101
1010000000101
1011111010101
1010000010001
1111111111111